

R 2500 600
NO textures/grass.xpm
SO textures/grass-fa.xpm
WE textures/grass-su.xpm
EA textures/grass-wi.xpm
S textures/tree1.xpm

F 255,255,0

C 0,0,255



1111111111111111111111111111111111111111
1111111111111111111111111111111111111111
1111111111111111111111111111111111111111
1111111111111111111111111111111111111111
111        11111111111111111111111111111
111        10000000001100000000000011111
111        10110000011100000020000011111
111        10010000000000000000000011111
1111111111110110200011100000000000011111
1111000000000110000011101111000111111111
1111111011111111101110000001000111111111
1111111011111111101 10101001000111111111
1111100000011010101110000001000111111111
1111000200000000000110000001000111111111
1111000000002000000110101001000111111111
1111100000111010101 11101111000111111111
11111110111 1110101 101111010N0011111111
11111111111 11111111 1111111111111111111
1111111111111111111111111111111111111111
