

R 1240 600
NO ./path_to_the_north_texture
SO ./path_to_the_south_texture
WE ./path_to_the_west_texture
EA ./path_to_the_east_texture
S ./path_to_the_sprite_texture

F 220,100,15

C 220,100,17






        11111111111111111111111111
        1000000000110000000000001
        101100000111000000200000111
        1001000000000000000000001
11111111101102000111000000000000111
1000000000110000011101111011111111
11110111111111011100000010001111111
1111011111111101 101010010001
11000000110101011100000010001
10002000000000001100000010001
10000000020000001101010010001
1100000111010101 111011110001111111
11110111 1110101 101111010N001
11111111 11111111 11111111111111
1111111111111111111111111111111
