


R     2880 1580

S textures/tree.xpm

NO textures/brick.xpm
SO textures/grey.xpm
WE textures/bl ue.xpm
EA textures/wood.xpm

F     255    , 255   ,  0


C 0   , 0              ,  255






111111111111111111111111111111111111111
100000000000000000011000002000200020001
101102000000000000011002000000000001001
100100000000000000000000000000000000001
111111111011000001110000000000002000001
10000000001100000111011110000000000011111
11110000000000011000000010000000000011111
11110111100111011101010012000000000011111
11020000110101011120000100000000000011111
10000000000000000000000010000000000011111
1200000002000000110101001000000000001111
1100000111010101111101111000000000001111
1100000111010101111101111000000000001111
1100000111010101111101111000000000001111
1100000111010101111101111000000000001111
1100000111010101111101111000000000001111
1100000111010101111101111000000000001111
1100000111010101111101111000000000001111
1100000111010101111101111000000000001111
1100000111010101111101111000000000001111
1100000111010101111101111000000000001111
1100000111010101111101111000000000001111
1100000111010101111101111000000000001111
1100000111010101111101111000000000001111
1100000111010101111101111000000000001111
1100000111010101111101111000000000001111
1100000111010101111101111000000000001111
1100000111010101111101111000000000001111
11110111 1110101 1011110100000N000001111
11111111 1111111 11111111111111111111
