

R      2 1000
S textures/barrel.xpm
NO textures/brick.xpm
SO textures/grey.xpm
WE textures/bl ue.xpm
EA textures/wood.xpm

F     255    , 255   ,  0

C 0   , 0              ,  255




111111111111111111111111111111111111111
100000000000000000011000000000000000001
101102000000000000011000000000200001001
100100000000000000000000000000000000001
111111111011000001110000000000000000001
100000000011000001110111100000000011111
111100000001011100000010000000000011111
1111011110011101110101001200000000011111
1102000011010101110020001100000000111111
1000000000000000000000001010000001011111
100000000200000011010100100000000001111
1100000111010101111101111010000001001111
11110111 1110101 1011110110000N000101111
11111111 1111111 11111111111111111111
