

R 1200 600
NO textures/brick.xpm
SO textures/grey.xpm
WE textures/blue.xpm
EA textures/wood.xpm
S textures/barrel.xpm

F 255,255,0

C 0,0,255



1111111111111111111111111111111111111111
1111111111111111111111111111111111111111
1111111111111111111111111111111111111111
1111111111111111111111111111111111111111
111        11111111111111111111111111111
111        10000000001100000000000011111
111        10110000011100000200000011111
111        10012000000000100000000011111
1111111111110110000011100000000000011111
1111000000000110000011101111000111111111
1111111011111111101110000001000111111111
1111111011111111101 10101001000111111111
1111100000011010101110000001202111111111
1111000000000002000110020001000111111111
1111000020000000000110101001000111111111
1111100000111010101111101111000111111111
11111110111  110101 101111010N0011111111
11111111111 11111111 1111111111111111101
1111111111111111111111111111111111111111
