

R 1200 600
NO textures/brick.xpm
SO textures/grey.xpm
WE textures/blue.xpm
EA textures/wood.xpm
S textures/barrel.xpm

F 255,255,0

C 0,0,255




111111111111111111111111111111111111111111
11100000000000000000011000000000000000001
11101102000000000000011000002200000001001
11100100000000000000000000000000000000001
11111111111101100000111000000000000000001
11110000000001100000111011110000000011111
11111110000000101110000001000000000011111
11111110111100111011101010010000000011111
11111020000110101011100200012020000011111
11110000000000000000000000010000000011111
11110000000020000001101010010000000011111
11111000001110101011111011110000000011111
11111110111 1110101 101111010N00000001111
11111111111 11111111111111111111111111111
11111111111111111111111111111111111111111
