

R 1920 1080
NO textures/brick.xpm
SO textures/bl ue.xpm
WE textures/wood.xpm
S textures/PineTree.xpm
EA textures/barrel.xpm

F 255,255,0

C 0,0,255



1111111111111
1200000000021
1000000000001
1000000000001
1000000000001
100000N000001
1000000000001
1000000000001
1200000000021
1111111111111
