        1111111111111111111111111
        1000000000110000000000001
        1011000001110000000000001
        1001000000000000000000001
111111111011000001110000000000001
100000000011000001110111100001101
111101111111110111000000100000001
111101111111110111010100100000001
110000001101010111000000100000001
100020000000000011000000100000001
100000000000000011010100100000001
11000001110101011111011110N011111
11110111 1110101 101111010001
11111111 1111111 111111111111
